25 18 
W W W W W W W W W W W W W W W W W W W W W W W W W
W G G G G G G G G G G G G G G G G G G G G G G G W
W G G G G G G G G G G G G G G G G G G G G G G G W
W G G G G G G G G G G G G G G G G G G G G G G G W
W G G G G G G G G P P P P P P P G G G G G G G G W
W G G G G G G G G P G G G G G P G G G G G G G G W
W G G G W W W W W P G G G G G P G G G G G G G G W
W G G W W A A A P P G G G G G P G G G G G G G G W
W G W A A A A A G G G G G G G P G G G G G G G G W
W G W A A A A A G G G G G G G P G G G G G G G G W
W G W A A A A A G G G G G G G P G G G G G G G G W
W G W A A A A A G G G G G G G P P P P P G G G G W
W G W A A A A A G G G G G G G G G G G G G G G G W
W G G G G G G G G G G G G G G G G G G G G G G G W
W G G G G G G G G G G G G G G G G G G G G G G G W
W G G G G G G G G G G G G G G G G G G G G G G G W
W G G G G G G G G G G G G G G G G G G G G G G G W
W W W W W W W W W W W W W W W W W W W W W W W W W